EEEEEEEEEEEEEEEEEEEEEE
EEEPPPPPPPPPPPPPPPPEEE
EPPPEEEEPEEEEPEEEEPPPE
EPEPPPPPOPPPPOPPPPPEPE
EPPBPPPPPPPPPPPPPPBPPE
EPEPPPEPEPEEPEPEPPPEPE 
EPEPPPPPPPEEPPPPPPPEPE
EPEPPPPPPPEEPPPPPPPEPE
EPPPPPPPPPPPPPPPPPPPPE 
EPEPEPEPPPSPPPPEPEPEPE
EPPPPPPPPEEEEPPPPPPPPE
EPPPPPPPPEEEEPPPPPPPPE 
EPEPEPEPPPPFPPPEPEPEPE
EPPPPPPPPPPPPPPPPPPPPE
EPEPPPPPPPEEPPPPPPPEPE 
EPEPPPPPPPEEPPPPPPPEPE
EPEPPPEPEPEEPEPEPPPEPE
EPPBPPPPPPPPPPPPPPBPPE 
EPEPPPPPOPPPPOPPPPPEPE
EPPPEEEEPEEEEPEEEEPPPE
EEEPPPPPPPPPPPPPPPPEEE
EEEEEEEEEEEEEEEEEEEEEE 