LLLLLLLLLLLLLLLLLLLLLL
TDDDWWWWWDDDDWDDDDDDDT
IDWDDDDDDDDWDWDWDWDWDI
IDWDWWWWWDDDDDDWDWDWDI
IDWDDDWDDDWDWWWWDWDWDI
IDWDWWWWWDDDDDDDDDDWDI
IDWDDDWDDDDWWWWWDWDWDI
IDWDWWWWWDDDDDDWDWDWDI
IDWDDDDDDDWDWWDWDWDWDI
IDPDWWWWDFDDBDDDDDDWDI
IDWDDDDDDGGGGDWWWWDPDI
IDPDWWWWDGGGGDDDDDDWDI
IDWDDDDDDSDDFDWWWWDPDI
IDWDWDWDWWDWDDDDDDDWDI
IDWDWDWDDDDDDWWWWWDWDI
IDWDWDWWWWWDDDDWDDDWDI
IDWDDDDDDDDDDWWWWWDWDI
IDWDWDWWWWDWDDDWDDDWDI
IDWDWDWDDDDDDWWWWWDWDI
IDWDWDWDWDWDDDDDDDDWDI
TDDDDDDDWDDDDWWWWWDDDT
LLLLLLLLLLLLLLLLLLLLLL