EEEEEEEEEEEEEEEEEEEEEE
EPPPEEEEEPPPPEPPPPPPPE 
EPEPPPPPPPPEPEPEPEPEPE
EPEPEPEPEPPPPPPEPEPEPE
EPEPPPEPPPEPEEEEPEPEPE
EPEPEPEPEPPPPPPPPPPEPE
EPEPPPEPPPPEEEEEPEPEPE
EPEPEPEPEPPPPPPEPEPEPE
EPEPPPPPPPEPEEPEPEPEPE
EPOPEEEEPPFPBPPPPPPEPE
EPEPPPPPPEEEEPEEEEPOPE
EPOPEEEEPEEEEPPPPPPEPE
EPEPPPPPPSPFPPEEEEPOPE
EPEPEPEPEEPEPPPPPPPEPE
EPEPEPEPPPPPPEPEPEPEPE
EPEPEPEEEEEPPPPEPPPEPE
EPEPPPPPPPPPPEPEPEPEPE
EPEPEPEEEEPEPPPEPPPEPE
EPEPEPEPPPPPPEPEPEPEPE
EPEPEPEPEPEPPPPPPPPEPE
EPPPPPPPEPPPPEEEEEPPPE 
EEEEEEEEEEEEEEEEEEEEEE      