LLLLLLLLTLLLLTLLLLLLLL
IWWDDDDDDGGGGDDDDDDWWI
IWWDWWWWDGGGGDWWWWDWWI
IWWDDDDDDSDDFDDDDDDWWI
IDDDWDDWWDWWDWWDDWDDDI
IDWDDWDDWDWWDWDDWDDWDI
IDDWDDWDDDWWDDDWDDWDDI
IDDDWDDWDDWWDDWDDWDDDI
IDWDDWDDWDWWDWDDWDDWDI
IPDDDDWDDDDDDDDWDDDDPI
IWWDDDDDWDWWDWDDDDDWWI
IWWDDDDDWDWWDWDDDDDWWI
IPDDDDWDDDDDDDDWDDDDPI
IDWDDWDDWDWWDWDDWDDWDI
IDDDWDDWDDWWDDWDDWDDDI
IDDWDDWDDDWWDDDWDDWDDI
IDWDDWDDWDWWDWDDWDDWDI
IDDDWDDWWDWWDWWDDWDDDI
IWWDDDDDDFDDBDDDDDDWWI
IWWDWWWWDGGGGDWWWWDWWI
IWWDDDDDDGGGGDDDDDDWWI
LLLLLLLLTLLLLTLLLLLLLL