EEEEEEEEEEEEEEEEEEEEEE
EPEPFPEPFPEEPFPEPFPEPE
EPEPEPEPEPEEPEPEPEPEPE
EPEPEPEPEPEEPEPEPEPEPE
EPEPEPEPEPEEPEPEPEPEPE
EPEPEPEPEPEEPEPEPEPEPE
EPEPEPEPEPEEPEPEPEPEPE
EPEPEPEPEPEEPEPEPEPEPE
EPEPEPEPEPEEPEPEPEPEPE
EPEPEPEPEPEEPEPEPEPEPE
EPEPEPEPEPEEPEPEPEPEPE
EPEPEPEPEPEEPEPEPEPEPE
EPEPEPEPEPEEPEPEPEPEPE
EPEPEPEPEPEEPEPEPEPEPE
EPEPEPEPEPEEPEPEPEPEPE
EPEPEPEPEPEEPEPEPEPEPE
EPEPEPEPEPEEPEPEPEPEPE
EPEPEPEPEPEEPEPEPEPEPE
EPEPEPEPEPEEPEPEPEPEPE
EPEPEPEPEPEEPEPEPEPEPE
EPFPEPFPEPFFPEPFPEPFPE
EEEEEEEEEEEEEEEEEEEEEE