EEEEEEEEEEEEEEEEEEEEEE
EEEPPPPPPEEEEPPPPPPEEE
EEEPEEEEPEEEEPEEEEPEEE 
EEEPPPPPPPPFPPPPPPPEEE
EPPPPPPPPPPPPPPPPPPPPE
EPEPEPEPEPEEPEPEPEPEPE
EPPPBPPPPPPPPPPPPBPPPE
EPEPEPEPEPEEPEPEPEPEPE
EPPPPPPOPPPPPPOPPPPPPE
EPEPEPEPEPEEPEPEPEPEPE
EPPPPPPPPPPPPPPPPPPPPE
EPPPPPPPPPSPPPPPPPPPPE
EPEPEPEPEPEEPEPEPEPEPE
EPPPPPPOPPPPPPOPPPPPPE
EPEPEPEPEPEEPEPEPEPEPE
EPPPBPPPPPPPPPPPPBPPPE
EPEPEPEPEPEEPEPEPEPEPE
EPPPPPPPPPPPPPPPPPPPPE
EEEPPPPPPPFPPPPPPPPEEE
EEEPEEEEPEEEEPEEEEPEEE
EEEPPPPPPEEEEPPPPPPEEE
EEEEEEEEEEEEEEEEEEEEEE