╓▬▬▬▬▬▬▬▬▬▬▬▬▬▬▬▬▬▬▬▬╖
▌■■╔════╗┌━━┐╔════╗■■▌
▌■■║■■■■║└┉┉┘║■■■■║■■▌ 
▌■■╠╦╦╦╦╬╦╬╬╦╬╦╦╦╦╣■■▌
▌╔═╬╩╬╩╬╩╬╩╩╬╩╬╩╬╩╬═╗▌
▌║■║■║■║■║■■║■║■║■║■║▌
▌╠═╬═╬═╬═╬══╬═╬═╬═╬═╣▌
▌║■║■║■║■║■■║■║■║■║■║▌
▌╠═╬═╬═╬═╬══╬═╬═╬═╬═╣▌
▌║■║■║■║■║■■║■║■║■║■║▌
▌╠╦╬╦╬╦╬╦╬╦╦╬╦╬╦╬╦╬╦╣▌
▌╠╩╬╩╬╩╬╩╬╩╩╬╩╬╩╬╩╬╩╣▌
▌║■║■║■║■║■■║■║■║■║■║▌
▌╠═╬═╬═╬═╬══╬═╬═╬═╬═╣▌
▌║■║■║■║■║■■║■║■║■║■║▌
▌╠═╬═╬═╬═╬══╬═╬═╬═╬═╣▌
▌║■║■║■║■║■■║■║■║■║■║▌
▌╚═╬╦╬╦╬╦╬╦╦╬╦╬╦╬╦╬═╝▌
▌■■╠╩╩╩╩╬╩╬╬╩╬╩╩╩╩╣■■▌
▌■■║■■■■║┌┉┉┐║■■■■║■■▌
▌■■╚════╝└━━┘╚════╝■■▌
╙▬▬▬▬▬▬▬▬▬▬▬▬▬▬▬▬▬▬▬▬╜