LLLLLLLLLLLLLLLLLLLLLL
IDWDWDWDWDWWDWDWDWDWDI
IDWDWDWDWDWWDWDWDWDWDI
IDWDWDWDWDWWDWDWDWDWDI
IDWDWDWDWDWWDWDWDWDWDI
IDWDWDWDWDWWDWDWDWDWDI
IDWDWDWDWDWWDWDWDWDWDI
IDWDWDWDWDWWDWDWDWDWDI
IDWDWDWDWDWWDWDWDWDWDI
IDWDWDWDWDWWDWDWDWDWDI
IDWDWDWDWDWWDWDWDWDWDI
IDWDWDWDWDWWDWDWDWDWDI
IDWDWDWDWDWWDWDWDWDWDI
IDWDWDWDWDWWDWDWDWDWDI
IDWDWDWDWDWWDWDWDWDWDI
IDWDWDWDWDWWDWDWDWDWDI
IDWDWDWDWDWWDWDWDWDWDI
IDWDWDWDWDWWDWDWDWDWDI
IDWDWDWDWDWWDWDWDWDWDI
IDWDWDWDWDWWDWDWDWDWDI
IDDDDDDDDDDDDDDDDDDDDI
LLLLLLLLLLLLLLLLLLLLLL