EEEEEEEEEEEEEEEEEEEEEE
EEEPPPPPPEEEEPPPPPPEEE
EEEOEEEEPEEEEPEEEEOEEE
EEEPPPPPPPSFPPPPPPPEEE 
EPPPEPPEEPEEPEEPPEPPPE
EPEPPEPPEPEEPEPPEPPEPE
EPPEPPEPPPEEPPPEPPEPPE
EPPPEPPEPPEEPPEPPEPPPE
EPEPPEPPEPEEPEPPEPPEPE
EPPPPPEPPPPPPPPEPPPPPE
EEEPPPPPEPEEPEPPPPPEEE
EEEPPPPPEPEEPEPPPPPEEE
EPPPPPEPPPPPPPPEPPPPPE
EPEPPEPPEPEEPEPPEPPEPE
EPPPEPPEPPEEPPEPPEPPPE
EPPEPPEPPPEEPPPEPPEPPE
EPEPPEPPEPEEPEPPEPPEPE
EPPPEPPEEPEEPEEPPEPPPE
EEEPPPPPPPFBPPPPPPPEEE
EEEOEEEEPEEEEPEEEEOEEE
EEEPPPPPPEEEEPPPPPPEEE
EEEEEEEEEEEEEEEEEEEEEE