▬▬▬▬▬▬▬▬T▬▬▬▬T▬▬▬▬▬▬▬▬
▌■■╔════╗┌━━┐╔════╗■■▌
▌■■║■■■■║└┉┉┘║■■■■║■■▌
▌■■╠═╦╦═╩╦══╦╩═╦╦═╣■■▌ 
▌╔═╣■╚╣■■║■■║■■╠╝■╠═╗▌
▌║■╚╗■╚╗■║■■║■╔╝■╔╝■║▌
▌╠╗■╚╗■╚╦╣■■╠╦╝■╔╝■╔╣▌
▌╠╩╗■╚╗■╚╣■■╠╝■╔╝■╔╩╣▌
▌║■╠╗■╚╗■║■■║■╔╝■╔╣■║▌
▌╚═╬╬╗■╠═╬══╬═╣■╔╬╬═╝▌
▌■■╠╬╬╦╣■║■■║■╠╦╬╬╣■■▌
▌■■╠╬╬╩╣■║■■║■╠╩╬╬╣■■▌
▌╔═╬╬╝■╠═╬══╬═╣■╚╬╬═╗▌
▌║■╠╝■╔╝■║■■║■╚╗■╚╣■║▌
▌╠╦╝■╔╝■╔╣■■╠╗■╚╗■╚╦╣▌
▌╠╝■╔╝■╔╩╣■■╠╩╗■╚╗■╚╣▌
▌║■╔╝■╔╝■║■■║■╚╗■╚╗■║▌
▌╚═╣■╔╣■■║■■║■■╠╗■╠═╝▌
▌■■╠═╩╩═╦╩══╩╦═╩╩═╣■■▌
▌■■║■■■■║┌┉┉┐║■■■■║■■▌
▌■■╚════╝└━━┘╚════╝■■▌
▬▬▬▬▬▬▬▬T▬▬▬▬T▬▬▬▬▬▬▬▬
