EEEEEEEEEEEEEEEEEEEEEE
EEEPPPOPPPPPPPPOPPPEEE
EEEFEPEPEEEEEEPEPEFEEE
EPPPEPEPPPPPPEPEPEPPPE 
EPEEEPEPEEPEPEPEPEEEPE
EPPPPPPPEEPEPEPPPPPPPE
EPEEEPEPEEPEPEPEPEEEPE
EPPPPPPPPPPPPEPPPPPPPE
EPEPEEEPEPEPPPEEEEEEPE
EPEPEEEPPPEPEPPPPPPEPE
EPEPPPPPEEEPBPPEEEPEPE
EPEPEEEPPSPEEEPPPPPEPE
EPEPPPPPPEPEPPPEEEPEPE
EPEEEEEEPPPEPEPEEEPEPE
EPPPPPPPEPPPPPPPPPPPPE
EPEEEPEPEPEPEEPEPEEEPE
EPPPPPPPEPEPEEPPPPPPPE
EPEEEPEPEPEPEEPEPEEEPE
EPPPEPEPEPPPPPPEPEPPPE
EEEFEPEPEEEEEEPEPEFEEE
EEEPPPOPPPPPPPPOPPPEEE
EEEEEEEEEEEEEEEEEEEEEE