╓▬▬▬▬▬▬▬▬▬▬▬▬▬▬▬▬▬▬▬▬╖
▌■■╔═╦╦═╦════╦═╦╦═╗■■▌
▌■■║┌┉┉┐║■■■■║┌┉┉┐║■■▌
▌■■║└┉┉┘║■■■■║└┉┉┘║■■▌ 
▌╔═╬╦╩╩╦╩╗■■╔╩╦╩╩╦╬═╗▌
▌║■╠╣■■╠═╣■■╠═╣■■╠╣■║▌
▌║■╠╝■■╚╦╣■■╠╦╝■■╚╣■║▌
▌║■║■■■■╚╣■■╠╝■■■■║■║▌
▌║■╠╦╦╦╦╦╬╦╦╬╦╦╦╦╦╣■║▌ 
▌║■╠╬╬╬╬╬╬╬╬╬╬╬╬╬╬╣■║▌
▌╠╦╬╬╬╬╬╬╬╬╬╬╬╬╬╬╬╬╦╣▌
▌╠╩╬╬╬╬╬╬╬╬╬╬╬╬╬╬╬╬╩╣▌
▌║■╠╬╬╬╬╬╬╬╬╬╬╬╬╬╬╣■║▌
▌║■╠╩╩╩╩╩╬╩╩╬╩╩╩╩╩╣■║▌
▌║■║■■■■╔╣■■╠╗■■■■║■║▌
▌║■╠╗■■╔╩╣■■╠╩╗■■╔╣■║▌
▌║■╠╣■■╠═╣■■╠═╣■■╠╣■║▌
▌╚═╬╩╦╦╩╦╝■■╚╦╩╦╦╩╬═╝▌
▌■■║┌┉┉┐║■■■■║┌┉┉┐║■■▌
▌■■║└┉┉┘║■■■■║└┉┉┘║■■▌
▌■■╚═╩╩═╩════╩═╩╩═╝■■▌
╙▬▬▬▬▬▬▬▬▬▬▬▬▬▬▬▬▬▬▬▬╜
   