LLLLLTLLLLLLLLLLTLLLLL
IGGDDDDDDDDDDDDDDDDGGI
IGGDWDWDWWWWWWDWDWDGGI
IDDFWDWDDDDDDWDWDWFDDI
IDWWWDWDWWDWDWDWDWWWDI
TDDDDPDDWWDWDWDDPDDDDT
IDWWWDWDWWDWDWDWDWWWDI
IDDDDDDDDDDDDWDDDDDDDI
IDWDWWWDWDWDDDWWWWWWDI
IDWDWWWDDDWDWDDDDDDWDI
IDWDDDDDWWWBDDDWWWDWDI
IDWDWWWDDDSWWWDDDDDWDI
IDWDDDDDDWDWDDDWWWDWDI
IDWWWWWWDDDWDWDWWWDWDI
IDDDDDDDWDDDDDDDDDDDDI
IDWWWDWDWDWDWWDWDWWWDI
TDDDDPDDWDWDWWDDPDDDDT
IDWWWDWDWDWDWWDWDWWWDI
IDDFWDWDWDDDDDDWDWFDDI
IGGDWDWDWWWWWWDWDWDGGI
IGGDDDDDDDDDDDDDDDDGGI
LLLLLTLLLLLLLLLLTLLLLL