EEEEEEEEEEEEEEEEEEEEEE
EEEPPPPPPPPPPPPPPPPEEE
EEEPEEEEPEEEEPEEEEPEEE
EEEPEEEEPEEEEPEEEEPEEE 
EPPPOPPFPPEEPPFPPOPPPE
EPEPPEEPEPEEPEPEEPPEPE
EPEPPEEPPPEEPPPEEPPEPE
EPEPEEEEPPEEPPEEEEPEPE
EPEPPEPPEPEEPEPPEPPEPE
EPEPPPPPPBPPBPPPPPPEPE
EPPPPPPPPPPPPPPPPPPPPE
EPPPPPPPPPPPPPPPPPPPPE
EPEPPPPPPBPPBPPPPPPEPE
EPEPPEPPEPEEPEPPEPPEPE
EPEPEEEEPPEEPPEEEEPEPE
EPEPPEEPPPEEPPPEEPPEPE
EPEPPEEPEPEEPEPEEPPEPE
EPPPOPPFPPEEPPFPPOPEPE
EEEPEEEEPEEEEPEEEEPEEE
EEEPEEEEPEEEEPEEEEPEEE
EEEPPPPPPPSPPPPPPPPEEE
EEEEEEEEEEEEEEEEEEEEEE
   