╓▬▬▬▬▬▬▬▬▬▬▬▬▬▬▬▬▬▬▬▬╖
▌■■╔═╦╦═╦════╦═╦╦═╗■■▌
▌■■║┌┉┉┐║■■■■║┌┉┉┐║■■▌
▌■■║└┉┉┘║■■■■║└┉┉┘║■■▌ 
▌╔═╬╦╩╩╦╩╗■■╔╩╦╩╩╦╬═╗▌
▌║■╠╣■■║■║■■║■║■■╠╣■║▌
▌║■╠╝■■╚╦╣■■╠╦╝■■╚╣■║▌
▌║■║■■■■╚╣■■╠╝■■■■║■║▌
▌║■╠╗■╔╗■║■■║■╔╗■╔╣■║▌
▌║■╠╬╦╬╬╦╬╦╦╬╦╬╬╦╬╣■║▌
▌╠╦╬╬╬╬╬╬╬╬╬╬╬╬╬╬╬╬╦╣▌
▌╠╩╬╬╬╬╬╬╬╬╬╬╬╬╬╬╬╬╩╣▌
▌║■╠╬╩╬╬╩╬╩╩╬╩╬╬╩╬╣■║▌
▌║■╠╝■╚╝■║■■║■╚╝■╚╣■║▌
▌║■║■■■■╔╣■■╠╗■■■■║■║▌
▌║■╠╗■■╔╩╣■■╠╩╗■■╔╣■║▌
▌║■╠╣■■║■║■■║■║■■╠╣■║▌
▌╚═╬╩╦╦╩╦╝■■╚╦╩╦╦╩╬═╝▌
▌■■║┌┉┉┐║■■■■║┌┉┉┐║■■▌
▌■■║└┉┉┘║■■■■║└┉┉┘║■■▌
▌■■╚═╩╩═╩════╩═╩╩═╝■■▌
╙▬▬▬▬▬▬▬▬▬▬▬▬▬▬▬▬▬▬▬▬╜
   