╓▬▬▬▬▬▬▬▬▬▬▬▬▬▬▬▬▬▬▬▬╖
▌┌┐╔═╦═╦══════╦═╦═╗┌┐▌
▌└┉║■║■║■■■■■■║■║■║┉┘▌  
▌╔═╝■║■╠══╦═╦═╬═╬■╩═╗▌ 
▌║■■■║■║■■║■║■║■║■■■║▌
▌╠═══╬═╣■■║■║■╠═╬═══╣▌
▌║■■■║■║■■║■╠═╣■║■■■║▌
▌╠═╦═╩═╬═╦╩╦╣■╚╦╩═╦═╣▌
▌║■║■■■║■║■╠╩╗■║■■║■║▌
▌║■║■■■╠═╬═╣■╠╦╩══╣■║▌
▌║■╠═══╣■║■╚╦╩╣■■■║■║▌
▌║■║■■■╠╦╩╗■║■╠═══╣■║▌
▌╠═╬═══╩╣■╠═╬═╣■■■║■║▌  
▌║■║■■■■╚╦╣■║■║■■■║■║▌
▌╠═╩═╦═╗■╠╩╦╩═╬═╦═╩═╣▌
▌║■■■║■║■║■║■■║■║■■■║▌
▌╠═══╬═╣═║■║■■╠═╬═══╣▌
▌║■║■║■║■║■║■■║■║■║■║▌
▌╚═╦═╣■╠═╬═╩══╣■╠═╬═╝▌
▌┌┉║■║■║■║■■■■║■║■║┉┐▌
▌└┘╚═╩═╩═╩════╩═╩═╝└┘▌
╙▬▬▬▬▬▬▬▬▬▬▬▬▬▬▬▬▬▬▬▬╜ 