▬▬▬▬▬T▬▬▬▬▬▬▬▬▬▬T▬▬▬▬▬
▌⏏⏏╔═╬֎╦══════╦֎╬═╗⏏⏏▌
▌⏏⏏F■║■║■■■■■■║■║■F⏏⏏▌  
▌╔═╝■║■╠══╦═╗■║■║■╚═╗▌ 
▌║■■■║■║■■║■║■║■║■■■║▌
T╬═══╬═╣■■║■║■╠═╬═══╬T
▌║■■■║■║■■║■║■║■║■■■║▌
▌╠═╦═╩═╬═╦╩╦╣■╚═╩═══╣▌
▌║■║■■■║■║■╠╩╗■■■■■■║▌
▌║■║■■■╠═╝■║■╠╦═══╗■║▌
▌║■╠═══╣■■■╚⚠╩╣■■■║■║▌
▌║■║■■■╠╦⚡╗■■■╠═══╣■║▌
▌║■╚═══╩╣■║■╔═╣■■■║■║▌  
▌║■■■■■■╚╦╣■║■║■■■║■║▌
▌╠═══╦═╗■╠╩╦╩═╬═╦═╩═╣▌
▌║■■■║■║■║■║■■║■║■■■║▌
T╬═══╬═╣■║■║■■╠═╬═══╬T
▌║■■■║■║■║■║■■║■║■■■║▌
▌╚═╗■║■║■╚═╩══╣■║■╔═╝▌
▌⏏⏏F■║■║■■■■■■║■║■F⏏⏏▌
▌⏏⏏╚═╬֎╩══════╩֎╬═╝⏏⏏▌
▬▬▬▬▬T▬▬▬▬▬▬▬▬▬▬T▬▬▬▬▬  
